#domain
hospital
#levelname
MATestCBS
#colors
red: 0, A
green: 1, B
blue: 2, C
purple:3, D
orange:4, E
cyan:5, F
#initial
++++++++++++++++++++
+0   3     2     + +
+  A   ++ ++++++++D+
+++  ++++E         +
+1 B   +++++++++++ +
+++C ++5+4         +
++    +  F         +
++++++++++++++++++++

#goal
++++++++++++++++++++
+                +D+
+ B    ++ ++++++++ +
+++  ++++   E      +
+    A +++++++++++ +
+++  ++ +          +
++C   +         F  +
++++++++++++++++++++

#end
