#domain
hospital
#levelname
MAPF03
#colors
blue: 0,1,A,B,C
#initial
+++++++++++++
+0   A    1 +
+        ++++
+           +
+     B  ++ +
+ C       + +
+++++++++++++
#goal
+++++++++++++
+0          +
+        ++++
+           +
+  C     ++ +
+     B   +A+
+++++++++++++
#end
