#domain
hospital
#levelname
MAPF03
#colors
blue: 0,1,A,B,C
#initial
+++++++++++++
+0   A      +
+        ++++
+           +
+     B  ++ +
+         + +
+++++++++++++
#goal
+++++++++++++
+           +
+  C     ++++
+           +
+        ++ +
+     B   +A+
+++++++++++++
#end
