#domain
hospital
#levelname
MATestCBSAgent3
#colors
red: 0, A
green: 1, B
#initial
++++++++++++
+  0     + +
+ ++++++++ +
+          +
++++++++++ +
+1         +
++++++++++++
#goal
++++++++++++
+        +0+
+ ++++++++ +
+1         +
++++++++++ +
+          +
++++++++++++
#end
