#domain
hospital
#levelname
SACrunch
#colors
blue: 0, A, B, C, D
#initial
++++++++
+0+    +
+  +   +
+ +B+  +
+  DC+ +
+ ++++ +
+      +
++++++++
#goal
++++++++
+ +CB  +
+  +   +
+ + +  +
+    + +
+ ++++ +
+      +
++++++++
#end
