#domain
hospital
#levelname
BrokeZac
#colors
blue: A
orange: B
red: 0, 2, C, E
purple: 1, 3, D, F
green: 4
grey: 5, 8, I
cyan: 6, J
pink: 7, G
lightblue: 9, H
#initial
++++++++++++++++++++++++++++++++++++++++++++++++++++++++
+            01         B  +A  +++J+++++++6++  +J+++++ +
+            +++      BB BB+++++++ +++++++ ++  + +++++ +
+                         B+++++++ +++++++ +++++ +++++ +
+                     BB BB++++++                +++++ +
+                      B B +++++++ +++++++++++++++++++ +
+            F          B  +++++++ +++++++++++ +++++++ +
+ C    B B   DD            +++++++ +++++++++++ +++++++ +
+ E    B B   DD            +++++++8++++ + + ++ +++++++ +
+ C    B B   DD            +           IIIIII          +
+ C    B B   DD            +++++++++++++ + + +++++++++++
++++++++++++++++++++++++++++++++++++++++++++++++++++++++
+       FFDFF           B  ++++++++++++   9            +
+         2            B BB++++++++++++ ++ ++ ++ +++++ +
+   3                     B+7          H  H  H  H    + +
+                      B BB+++++++++++++++++++++++++H  +
+                       B  +G       H       H        + +
+        B    5            + +++++++ +++++++ +++++++++ +
+      B B                 + +                         +
+      B B                 + + +++++G+++++++++++++++++++
+      B B         4       + + ++++++++++++++++++++++  +
+      B B                 +  H                        +
++++++++++++++++++++++++++++++++++++++++++++++++++++++++
#goal
++++++++++++++++++++++++++++++++++++++++++++++++++++++++
+            01         B  +A  +++ +++++++ ++  + +++++J+
+            +++      BBDBB+++++++ +++++++ ++  + +++++ +
+                     DDFDB+++++++ +++++++ +++++ +++++ +
+                     BBDBB++++++                +++++ +
+                      BDB +++++++ +++++++++++++++++++ +
+                       B  +++++++ +++++++++++ +++++++ +
+      BCB                 +++++++ +++++++++++6+++++++ +
+      BCB                 +++++++ ++++ + + ++ +++++++ +
+      BEB                 +J                          +
+      BCB                 +++++++++++++ + + +++++++++++
++++++++++++++++++++++++++++++++++++++++++++++++++++++++
+                       B  ++++++++++++                +
+                      B2BB++++++++++++ ++ ++ ++ +++++ +
+                       53B+                         + +
+                      B4BB+++++++++++++++++++++++++   +
+                       B  +                         + +
+       FB                 + +++++++ +++++++ +++++++++ +
+      BFB                 + +                         +
+      BDB                 + + +++++ +++++++++++++++++++
+      BFB                 + + ++++++++++++++++++++++GG+
+      BFB                 +                          7+
++++++++++++++++++++++++++++++++++++++++++++++++++++++++
#end