#domain
hospital
#levelname
CphAirprt
#colors
blue: 0, A
red: 1, B
green: 2, C
cyan: 3, D
purple: 4, E
orange: 5, F
pink: 6, G
grey: 7, H
lightblue: 8, I
brown: 9, J
#initial
+++++++++++++++++++++++++++++++++++++++++++
+          ++++++++++++    +++            +
+          ++++++++++++++++++++++++       +
+         +++++++++++++++++++++++++++++++ +
+         +++++++++++++++++++++++++++++++ +
+         ++        +++++++++++++++++++++ +
+        ++         ++       +++++++++++  +
+        ++         ++          ++        +
+ A     ++          ++          ++        +
+ B     ++          ++          ++        +
+       ++C2       ++          +++        +
+ ++    ++       3D++        5F++         +
+7 ++  ++       4E+++         +++         +
+   +++++         ++    + G   ++     I    +
+ +    +++        ++    + H   ++          +
+ +++    ++       ++    +     ++          +
+8 +++++         ++    ++    ++J9         +
+   ++++++       ++    ++     ++          +
++     ++++ +    +++   ++     ++          +
+++++     + ++++       ++     ++          +
+++++++++    ++++++    ++     ++          +
+16 ++++++++     ++  +        ++          +
+++   +++++++++      +++      ++          +
+++++   +++++++++     ++++                +
+++++++   ++++++++      ++                +
+++++++++   +++++++           +++         +
+++++++++++   +++++  ++         ++++      +
+++++++++++++   +++  +++           ++     +
+++++++++++++++   +  ++                   +
+++++++++++++++++         +++++++         +
+++++++++++++++++++     ++++++++++        +
++++++++++++++++++++     ++++++++++      0+
+++++++++++++++++++++++++++++++++++++++++++
#goal
+++++++++++++++++++++++++++++++++++++++++++
+          ++++++++++++    +++            +
+          ++++++++++++++++++++++++       +
+         +++++++++++++++++++++++++++++++ +
+         +++++++++++++++++++++++++++++++ +
+         ++        +++++++++++++++++++++ +
+        ++         ++       +++++++++++  +
+        ++         ++          ++        +
+     0A++          ++          ++        +
+     1B++          ++          ++        +
+       ++    C    ++          +++        +
+ ++    ++    D    ++     F    ++         +
+  ++  ++     E   +++         +++         +
+   +++++         ++    +   6G++I8        +
+ +    +++        ++    +   7H++          +
+ +++    ++       ++    +     ++          +
+9 +++++         ++    ++    ++      J    +
+5  ++++++       ++    ++     ++          +
++     ++++ +    +++   ++     ++          +
+++++     + ++++       ++     ++          +
+++++++++    ++++++    ++     ++          +
+243++++++++     ++  +        ++          +
+++   +++++++++      +++      ++          +
+++++   +++++++++     ++++                +
+++++++   ++++++++      ++                +
+++++++++   +++++++           +++         +
+++++++++++   +++++  ++         ++++      +
+++++++++++++   +++  +++           ++     +
+++++++++++++++   +  ++                   +
+++++++++++++++++         +++++++         +
+++++++++++++++++++     ++++++++++        +
++++++++++++++++++++     ++++++++++       +
+++++++++++++++++++++++++++++++++++++++++++
#end