#domain
hospital
#levelname
Hashtag
#colors
red: 0, A
blue: 1, B
green: 2, C
purple: 3, D
#initial
++++++++++++
+++0 ++ A+++
+++  ++  +++
+         2+
+D   ++    +
+++ ++++ +++
+++ ++++ +++
+    ++   C+
+3         +
+++  ++  +++
+++B ++ 1+++
++++++++++++
#goal
++++++++++++
+++  ++B0+++
+++  ++  +++
+C         +
+3   ++    +
+++ ++++ +++
+++ ++++ +++
+    ++   2+
+         D+
+++  ++  +++
+++1A++  +++
++++++++++++
#end