#domain
hospital
#levelname
Monad
#colors
red: 0,3,4,C
blue: 1,A
purple: 2,B
#initial
++++++++++++++++++++
+     +            +
+     +            +
+ + + +            +
+ +0+              +
+ + + +++++++++++  +
+ + + +         +  +
+ + + + +++ +++ +  +
+ + + + +     + +  +
+ + + +B+     + +  +
+ +3+ +2+     + +  +
+ + + + +     + +  +
+ + + + +    4+ +  +
+ +A+ + +++++++ +  +
+ +1+ +         +  +
+ +++ +++++ +++++  +
+ +++ +     C      +
+     +            +
+++ ++++++++++++++++
+                  +
+                  +
++++++++++++++++++++
#goal
++++++++++++++++++++
+  4  +            +
+  C  +            +
+ + +2+            +
+ + +B             +
+ + + +++++++++++  +
+ + + +         +  +
+ + + + +++ +++ +  +
+ + + + +     + +  +
+ + + + +     + +  +
+ + + + +     + +  +
+ + + + +     + +  +
+ + + + +     + +  +
+ + + + +++++++ +  +
+ + + +         +  +
+ +++ +++++ +++++  +
+ +++ +            +
+     +            +
+++ ++++++++++++++++
+                03+
+                1A+
++++++++++++++++++++
#end
