#domain
hospital
#levelname
OnlyLast
#colors
blue: 0, A
orange: 1, 3
grey: 2
#initial
+++++++++++++++++++++
+    0 A            +
+   A            ++++
+     1          ++ +
+     +             +
+        2        + +
+             3     +
+                   +
+                   +
+++++++++++++++++++++
#goal
+++++++++++++++++++++
+                   +
+                ++++
+                ++ +
+     +             +
+    A2 A         + +
+                   +
+                   +
+                   +
+++++++++++++++++++++
#end
