#domain
hospital
#levelname
planB
#colors
blue: 0, A
green: 1,B
purple:3,D
red:2,C
#initial
++++++++++++++
++++++0+++++++
++++++ +++++++
++++++ +++++++
++++++ +++++++
++++++ +++++++     
+1   BA      +
+     CD    2+
+3           +
++++++++++++++
#goal
++++++++++++++
++++++ +++++++
++++++ +++++++
++++++ +++++++
++++++ +++++++
++++++ +++++++     
+           B+
+C           +
+     A    D +
++++++++++++++
#end
