#domain
hospital
#levelname
Qbit
#colors
red:0,A,B,4
cyan:3,U
blue:1,I
green:2,Q,T
#initial
++++++++++++++++++++++++++++++++++
++++++++  QBIT      ++++++++   +++
+++++++++++  ++++++     I      +++
+++++++++     ++++++++++++++++ +++
+1 AA         +  +++++2          +
++++++        ++++++  ++++++++U+++
++++++  4        +             3 +
++++++           +++++++++       +
++++++     ++++ ++QAUAB+++ +++++ +
++++++     ++++ ++  U  +++ +++++ +
++++++     ++++ ++  0  +++       +
++++++ U+++++++ ++     ++++++++  +
+++++++++++++++ ++I   T++++++++  +
++++++++        +++++++++++++    +
++++++++    I                    +
++++++++++++++++++++++++++++++++++
#goal
++++++++++++++++++++++++++++++++++
++++++++   U        ++++++++   +++
+++++++++++  ++++++            +++
+++++++++     ++++++++++++++++ +++
+             +  +++++3U         +
++++++        ++++++  ++++++++ +++
++++++           +               +
++++++           +++++++++       +
++++++     ++++ ++    B+++ +++++ +
++++++     ++++ ++  U  +++ +++++ +
++++++     ++++ ++  0  +++       +
++++++  +++++++ ++     ++++++++  +
+++++++++++++++ ++IA AT++++++++  +
++++++++        +++++++++++++    +
++++++++ I           A   12     B+
++++++++++++++++++++++++++++++++++
#end