#domain
hospital
#levelname
Spagettii
#colors
blue: 0, 1, 2, 3, 4, 5, 6, 7, 8, 9,  A, B, C, D, E, F, G, H, I, J
#initial
++++++++++++++++++++++++++++++++++++++++++++++++++++++++++++++++++++
+ ++++++   +   +   +   +   +   +   +   +   +   +   +   +   +   +   +
+   ++++ + + + + + + + + + + + + + + + + + + + + + + + + + + + +0  +
+1+      +   +   +   + + + + + + + + +   +   +   +   +   + + + +++ +
++++++++++++++++++++++   +   +   +   +++++++++++++++++++++   +     +
+   +++       +     +++++++++++++++++++++       +     ++++++++++++++
+3    + +++++ + +++ +        +++        + +++++ + +++ +        ++ 2+
+++++ + +     + +++ + ++++++ +++ ++++++ + +     + +++ + ++++++ ++  +
++    + + +++++ ++  + ++++++ +++ +++    + + +++++ ++  + ++++++ +++ +
++ ++++ +       ++ ++ +      +++ +++ ++++ +       ++ ++ +      +++ +
++      ++++++++++    + ++++++++ +++      ++++++++++    + ++++++++ +
+++++++++++++++++++++++          ++++++++++++++++++++++++          +
++++++++++++++++++++++++++++++++++++++++++++++++++++++++++++++++++++
+                                                                  +
++                                                                ++
+++         +                                           +        +++
++++        +E+    +                             +    +I+       ++++
+++++       +B+    + +     +    ++++++++++     + +    +F+      +++++
++++++      +D+    + +     +    4765     +     + +    +J+     ++++++
+++++++     +A+    + +     +++++++++     +     + +    +G+    +++++++
+++++++++   +C+    + +                         + +    +H+   ++++++++
++++++++++++++++++++++++++++++++++++++++++++++++++++++++++++++++++++
#goal
++++++++++++++++++++++++++++++++++++++++++++++++++++++++++++++++++++
+0++++++   +   +   +   +   +   +   +   +   +   +   +   +   +   +1  +
+   ++++ + + + + + + + + + + + + + + + + + + + + + + + + + + + +   +
+ +      +   +   +   + + + + + + + + +   +   +   +   +   + + + +++ +
++++++++++++++++++++++   +   +   +   +++++++++++++++++++++   +     +
+  2+++       +     +++++++++++++++++++++       +     ++++++++++++++
+     + +++++ + +++ +        +++        + +++++ + +++ +        ++  +
+++++ + +     + +++ + ++++++ +++ ++++++ + +     + +++ + ++++++ ++3 +
++    + + +++++ ++  + ++++++ +++ +++    + + +++++ ++  + ++++++ +++ +
++ ++++ +       ++ ++ +      +++ +++ ++++ +       ++ ++ +      +++ +
++      ++++++++++    + ++++++++ +++      ++++++++++    + ++++++++ +
+++++++++++++++++++++++          ++++++++++++++++++++++++          +
++++++++++++++++++++++++++++++++++++++++++++++++++++++++++++++++++++
+                                                                  +
++                                                                ++
+++         +                                           +        +++
++++        + +    +A              4   5         +    + +       ++++
+++++       + +    +E+     +    ++++++++++     +I+    + +      +++++
++++++      + +    +B+     +  7          +     +J+    + +     ++++++
+++++++     + +    +C+     +++++++++ 6   +     +H+    + +    +++++++
+++++++++   + +    +D+                         +F+    + +   ++++++++
++++++++++++++++++++++++++++++++++++++++++++++++++++++++++++++++++++
#end
