#domain
hospital
#levelname
Spds
#colors
blue: 0,1,2
#initial
+++++++++++++
+      1    +
+           +
++++++ ++++++
+    0   2  +
+  +     +  +
+        +  +
+++++++++++++
#goal
+++++++++++++
+       0   +
+           +
++++++ ++++++
+           +
+2 +     +  +
+1       +  +
+++++++++++++
#end
