#domain
hospital
#levelname
WallE
#colors
Orange: 0, A
Lightblue: 1, B
Green: P
Red: 2,C
Brown: T
Pink: 3,4,5,6,7,8,9,L
#initial
++++++++++++++++++++++++++++++++++++++++++++++++++++++++++++++++++++++++++++++
+++                                                            + +           +
++                                                              ++    +      +
+                                                                +++++ ++++  +
+                                                                ++ L  6L  +++
+                                                                P2C 3 L 7   +
+                                                                ++9L  L4    +
+                                                                + ++5L  8 +++
+                                                                +   ++  ++  +
+                                                                +    +  +   +
+                                                                +   +    +  +
+                                                                +    +  +   +
+                                                                +    +  +   +
+                                                                +    + +    +
+                                                                +    + +    +
+                                                                +     +     +
+                                                                +
+                                                                +
+                                                                +
+                                                                +
+                                                                +
+                                                                +
+                                                                +
+                             0                                  +
+                                     A                          +
+                                                                +
+             B     TTTTTTTTTTTTTTTTTTTTTTT                      +
+                   TTTTTTTTTTTTTTTTTTTTTTT                      +
+                   TTTTTTTTTTTTTTTTTTTTTTT                      +
+                   TTTTTTTTTTTTTTTTTTTTTTT                      +
+                                                                +
+                         B                  A                   +
+                                                                +
+                               1                                +
+                                                                +
+                                                                +
+                                                                +
+                                                                +
+                                                                +
+                                                                +
+                                                                +
+                                                                +
+                                                                +
+                                                                +
+                                                                +
+                                                                +
+                                                                +
+                                                                +
+                                                                +
+                                                                +
+                                                                +
+                                                                +
+                                                                +
+                                                                +
+                                                                +
+                                                                +
++                                                              ++
+ +                                                            + +
++++++++++++++++++++++++++++++++++++++++++++++++++++++++++++++++++
#goal
++++++++++++++++++++++++++++++++++++++++++++++++++++++++++++++++++++++++++++++
+++                                                            + +           +
++                                                              ++    +      +
+                                                                +++++ ++++  +
+                                                                ++        +++
+                                                                            +
+                                                                ++          +
+                                                                + ++      +++
+                                                                +   ++  ++  +
+                                                                +    +  +   +
+                                                                +   +    +  +
+                                                                +    +  +   +
+                                                                +    +  +   +
+                                                                +    + +    +
+                                                                +    + +    +
+                                                                +     +     +
+                                                                +
+                                                                +
+                                                                +
+                                                                +
+                                                                +
+                                                                +
+                                                                +
+                            01                                  +
+                   B                                            +
+                                                                +
+                                                                +
+                                                                +
+             B                                                  +
+                                               A                +
+                                                                +
+                                                                +
+                      A                                         +
+                                                                +
+                                                                +
+                                                                +
+                                                                +
+                                                                +
+                                                                +
+                                                                +
+                                                                +
+                                                                +
+                                                                +
+                                                                +
+                                                                +
+                                                                +
+                                                                +
+                                                                +
+                                                                +
+                                                                +
+                                                                +
+                                                                +
+                                                                +
+                                                                +
+                                                                +
+                                                                +
++                                                              ++
+ +                                                            + +
++++++++++++++++++++++++++++++++++++++++++++++++++++++++++++++++++
#end